NO ./textures/brick.xpm
SO ./textures/lego.xpm
WE ./textures/kandinsky.xpm
EA ./textures/binary.xpm

F 50,50,50
C 10,10,10

1111111111111111
1E00002000000001
1000000111110001
1002001002020001
1000021002111111
1020001002000201
1000111110020021
1000100011111001
1000100010000001
100010001000000111111111111111
100000001000020000000020000201
100000001000000000000000000001
100000001002000000000010020001
101101111000000011011110000001
100000000000000000000000000001
111111111111111111111111111111