NO ./textures/door.xpm
SO ./textures/gray_wall.xpm
WE ./textures/wall_3.xpm
EA ./textures/futuristic_wall.xpm

F 20,20,20
C 200,200,200

111111111
111111111