NO ./textures/futuristic_wall.xpm
SO ./textures/futuristic_wall.xpm
WE ./textures/futuristic_wall.xpm
EA ./textures/futuristic_wall.xpm

F 128,128,128
C 32,32,32

 1111111        111111111       1111111
110000011      10000000001     110000011
100000001     1000000000001    100000001
 1000001     100000000000001    1000001
  11011      1000000000000001    11011
   101        1000000100000001    101
   101         1000011100000001   101
   1011111111111000001000000011111101
   1000000000000000000000000110000001
   1011111111111000000000001111111101
   101         100000000001       101
   101        100000000001        101
  11011      100000000001        11011
 1000001     1000000N0001       1000001
100000001     10000000001      100000001
110000011      1000000001      110000011
 1111111        111111111       1111111